NO ./assets/Brick_nord.xpm
SO ./assets/Brick_sud.xpm
WE ./assets/Brick_west.xpm
EA ./assets/Brick_est.xpm

C 253,108,158
F 248,142,85

        11111
        10001
        10001
1111    10001
1100111111111
10001
10001
10101
10001
10001
10001
10001
10001
10N01
11111
