NO ./assets/Brick_nord.xpm
SO 					./assets/Brick_sud.xpm
WE ./assets/Brick_west.xpm
EA ./assets/Brick_est.xpm
DO ./assets/white_open.xpm
FL ./assets/Brick.xpm
CE ./assets/prototype_green.xpm
SP ./assets/doorcancel.xpm

C 255,0,0



F 104,104,104



11111111111111111111111111111111111111111111111111111111111110
10001110000000000000000000000000000000000000000000000000000001
10001110000000000000000000000000000000000000000000000000000001
10001110000000000000000000000000000000000000000000000000000001
10001110000000000000011111111111111111000000000000000000000001
10001110000000000000000000000000000000000000000000000000000001
10001110000000000000000000000000000000000000000000000000000001
10001110000000000000000000000000000000000000000000000000000001
1000111000000000000000000000000000000000000D000000000000000001
1000111111111111000000000000000S000000000000000000000000000001
10001110000000000000000000000000000000000000000000000000000001
1000111000000000000000000000001D1000000000000000000000000000001
100000000000000000000000000000D0D00000000000000000000000000001
1000111000000000000000000000001D100000000000000000000000000001
10001110000000000000000000000000000000000000000000000000000001
10001110000000000000000000000000000000000000000000000000000001
10000000000000000000000000000000000000000000000000000000000001
11111111111111111111111111111111111111111111111111111111111111
