NO ./assets/Brick_nord.xpm
SO 					./assets/Brick_sud.xpm
WE ./assets/Brick_west.xpm
EA ./assets/Brick_est.xpm
DO ./assets/Brick.xpm

C 255,0,0



F 104,104,104



11111111111111111111111111111111111111111111111111111111111110
10001110000000000000000000000000000000000000000000000000000001
10001110000000000000000000000000000000000000000000000000000001
10001110000000000000000000000000000000000000000000000000000001
10001110000000000000011111111111111111000000000000000000000001
10001110000000000000000000000000000000000000000000000000000001
10001110000000000000000000000000000000000000000000000000000001
10001110000000000000000000000000000000000000000000000000000001
10001110000000000000000000000000000000000000000000000000000001
10001111111111110000000000N00000000000000000000000000000000001
10001110000000000000000000000000000000000000000000000000000001
10001110000000000000000000000000000000000000000000000000000001
100011100000000000000000000001D1000000000000000000000000000001
1000111000000000000000000000100010000000000000000000000000001
1000111000000000000000000001000001100000000000000000000000001
10001110000000000000000000100000000100000000000000000000000001
10001110000000000000000000D00000000D00000000000000000000000001
10001110000000000000000000100000000100000000000000000000000001
10001110000000000000000000010000001000000000000000000000000001
10001110000000000000000000001000010000000000000000000000000001
100011100000000000000000000001DD100000000000000000000000000001
10001110000000000000000000000000000000000000000000000000000001
10001110000000000000000000000000000000000000000000000000000001
10001110000000000000000000000000000000000000000000000000000001
10000000000000000000000000000000000000000000000000000000000001
11111111111111111111111111111111111111111111111111111111111111
