WE ./path_to_the_west_texture
NO ./path_to_the_north_texture
EA ./path_to_the_east_texture
SO ./path_to_the_south_texture

C 253,108,158
F 248,142,85



11111111111
10001110001
10000100001
10000000001
10000N00001
10000000001
11111111111
