WE ./path_to_the_west_texture
NO ./path_to_the_north_texture
EA ./path_to_the_east_texture
SO ./path_to_the_south_texture

C 100,120,130



F 220,245,255
              V 
     11     110111
   111111  11F0001
111000001 10000001
100000001111111011
110011100000000011
1011   10000N00001
101    1000000000111111
       11111111111111 