WE ./path_to_the_west_texture
NO ./path_to_the_north_texture
EA ./path_to_the_east_texture
SO ./path_to_the_south_texture

F 220,245,0
C 100,100,0

     11     111111
           11F0001
111000001 100V0001
000000001111111011
110011010000000011
101    10000N00001
101    1000000000111111
    11111111111111
1
1
1
1
1
1
1
