WE ./path_to_the_west_texture
NO ./path_to_the_north_texture
EA ./path_to_the_east_texture
SO ./path_to_the_south_texture

C 100,120,130



F 220,245,255
              
     11     110111
           11F0001
111000001 10000001
000000001111111011
110011010000000011
101    10000N00001
101    1000000000111111
    11111111111111
1
1
1
1
1
1
1
