WE ./path_to_the_west_texture
NO ./path_to_the_north_texture
EA ./path_to_the_east_texture
SO ./path_to_the_south_texture

C 253,108,158
F 248,142,85



111111111111
100011100001
100001000001
100100001001
100000010001
10N000000001
100000000001
100000000001
100000000001
100000000001
111111111111
