NO ./assets/Brick_nord.xpm
SO ./assets/Brick_sud.xpm
WE ./assets/Brick_west.xpm
EA ./assets/Brick_est.xpm

C 55,55,55
F 104,104,104

1111111111111111111111111111111111111111
1000000000000000000111111111111111111111
1111111111110000010000000000000000000001
1000000000010000010111111111111111111001
1011111111010111010000000000000000001001
1010000000010000011111111111111111101001
1010111111110111110000000000000000101001
1010000000000100001111111111111110101001
1011111111111101111000000000000010101001
1000000000000000001011111111111010101001
1111111111111111101010000000001010101001
1000000000000000101010111111101110101001
1011111111111110101010000000101011010101
1000000000000010101010111110101110001001
111111111110101010101000001N001011101001
1000000000101010101011111011101000000001
1011111110101010101000001010101111111001
1000000010101000101111101010000000000001
1111111111111111111111111111111111111111

