NO ./assets/Brick_nord.xpm
SO ./assets/Brick_sud.xpm		
WE ./assets/Brick_west.xpm		
EA ./assets/Brick_est.xpm       

C 255,0,0
F 104,104,104



11111111111111111111111111111111111111111111111111111111111111
10001110000000000000000000000000000000000000000000000000000001
10001110000000000000000000000000000000000000000000000000000001
10001110000000000000000000000000000000000000000000000000000001
10001110000000000000011111111111111111000000000000000000000001
10001110000000000000000000000000000000000000000000000000000001
10001110000000000000000000000000000000000000000000000000000001
10001110000000000000000000000000000000000000000000000000000001
10001110000000000000000000000000000000000000000000000000000001
10001111111111110000000000000000000000000000000000000000000001
100011100000000000000000000000N0000000000000000000000000000001
10001110000000000000000000000011100000000000000000000000000001
10000000000000000000000000000010100000000000000000000000000001
10001110000000000000000000000011100000000000000000000000000001
10001110000000000000000000000000000000000000000000000000000001
10001110000000000000000000000000000000000000000000000000000001
10000000000000000000000000000000000000000000000000000000000001
11111111111111111111111111111111111111111111111111111111111111
