1111111111111111111111111111111111111111
1000000000000000000111111111111111111111
1111111111110000010000000000000000000001
1000000000010000010111111111111111111001
1011111111010111010000000000000000001001
1010000000010000011111111111111111101001
1010111111110111110000000000000000101001
1010000000000100001111111111111110101001
1011111111111101111000000000000010101001
1000000000000000001011111D11111010101001
1111111111111111101010000000001010101001
1000000000000000101010111111101110101001
1011111111111110101010000000101011010101
100000000000001010101011111O101110001001
11111111111010101010100000O0D01011101001
100000000010101010101111101N10100000D001
1011111110101010101000001010101111111001
1000000010101000101111101010000000000001
1111111111111111111111111111111111111111

NO ./assets/Brick_nord.xpm
SO ./assets/Brick_sud.xpm
WE ./assets/Brick_west.xpm
EA ./assets/Brick_est.xpm
DO ./assets/Door_open2.xpm
FL ./assets/floor2.xpm
CE ./assets/ceiling.xpm
SP ./assets/Door_closed2.xpm
SP ./assets/Door_closed2.xpm
SP ./assets/Door_closed2.xpm

C 255,0,0
F 104,104,104

1
