NO ./assets/Brick_north.xpm
SO ./assets/Brick0.xpm
SO ./assets/Brick0.xpm
SO ./assets/Brick1.xpm
SO ./assets/Brick2.xpm
SO ./assets/Brick3.xpm
SO ./assets/Brick4.xpm
WE ./assets/Brick_south.xpm
EA ./assets/Brick_east.xpm
OD ./assets/Door_open2.xpm
CD ./assets/Door_closed2.xpm
FL ./assets/floor2.xpm
CE ./assets/ceiling.xpm

1111111111111111111111111111111111111111
1000000000000000000111111111111111111111
1111111111110000010000000000000000000001
10000000000100000101111111111D1111111001
1011111D11010111010000000000000000001001
1010000000010000011111111111111111101001
1010111111110111110000000000000000101001
1010000000000100001111111111111110101001
1011111D11111101111000000000000010101001
1000000000000000001011111D11111010101001
1000000111111111101010000000001010101001
1001000000000000101010111111101110101001
1010000011111110101010000000101011010101
100000000000001010101011111D101110001001
1111D1111110101010101000000N001011101001
100000000010101010101111101D10100000D001
1011111110101010101000001010101111111001
1000000010101000101111101010000000000001
1111111111111111111111111111111111111111
