NO ./assets/Brick_nord.xpm
SO ./assets/Brick_sud.xpm
SO ./assets/Brick1.xpm           
SO ./assets/Brick3.xpm
SO ./assets/Brick0.xpm
SO ./assets/Brick4.xpm
SO ./assets/Brick2.xpm
WE ./assets/Brick_west.xpm
EA ./assets/Brick_est.xpm
DO ./assets/Door_open2.xpm
FL ./assets/floor2.xpm
CE ./assets/ceiling.xpm
SP ./assets/Door_closed2.xpm
SP ./assets/Door_closed2.xpm
SP ./assets/Door_closed2.xpm

11111111111111111111111111111
1N1
 1
