WE ./path_to_the_west_texture
NO ./path_to_the_north_texture
EA ./path_to_the_east_texture
SO ./path_to_the_south_texture

C 253,108,158
F 248,142,85



              1
     11     110111
   111111  1100001
111000001 10000001
100000001111011011
110011100001010011
1011   10S01010001
101    1000010000111111
 1      11111111111111

