NO ./assets/prototype_north.xpm
SO ./assets/prototype_south.xpm
WE ./assets/prototype_west.xpm
EA ./assets/prototype_east.xpm

C 253,108,158
F 248,142,85

        11111
        10001
        10001
1111    10001
1100111111111
10001
10001
10101
10001
10001
10001               111111
10001111111111111111100001
10000000000000000000000001
10N00000000000000000000001
11111111111111111111111111
