NO ../../textures/prototype_red.xpm
SO ../../textures/prototype_blue.xpm
WE ../../textures/prototype_yellow.xpm
EA ../../textures/prototype_green.xpm

C 53,41,34
F 45,33,27

11111111111111111111111111111111111111111111111111111111111110
10001110000000000000000000000000000000000000000000000000000001
10001110000000000000000000000000000000000000000000000000000001
10001110000000000000000000000000000000000000000000000000000001
10001110000000000000011111111111111111000000000000000000000001
10001110000000000000000000000000000000000000000000000000000001
10001110000000000000000000000000000000000000000000000000000001
10001110000000000000000000000000000000000000000000000000000001
10001110000000000000000000000000000000000000000000000000000001
10001111111111110000000000N00000000000000000000000000000000001
10001110000000000000000000000010000000000000000000000000000001
10001110000000000000000000000101000000000000000000000000000001
10001110000000000000000000001000100000000000000000000000000001
10001110000000000000000000010000010000000000000000000000000001
10001110000000000000000000100000001000000000000000000000000001
10001110000000000000000001000000000100000000000000000000000001
10001110000000000000000010000000000010000000000000000000000001
10001110000000000000000001000000000100000000000000000000000001
10001110000000000000000000100000001000000000000000000000000001
10001110000000000000000000010000010000000000000000000000000001
10001110000000000000000000001000100000000000000000000000000001
10001110000000000000000000000101000000000000000000000000000001
10001110000000000000000000000010000000000000000000000000000001
10001110000000000000000000000000000000000000000000000000000001
10000000000000000000000000000000000000000000000000000000000001
11111111111111111111111111111111111111111111111111111111111111
